{
    "dungeon": [
        {
            "id": 1,
            "data": [
                [3], [2],
                [3], [3],
                [3], [4],
                [3], [5],
                [4], [5],
                [5], [5],
                [6], [5],
                [7], [5],
                [8], [5],
                [8], [6],
                [8], [7],
                [8], [8],
                [8], [9],
                [8], [4],
                [9], [6],
                [7], [7]
            ]
        },
        {
            "id": 2,
            "data": [
              
    
            ]
        }
    ]

}